R 800 800
NO ./textures/north.xpm
SO ./textures/south.xpm
WE ./textures/west.xpm
EA ./textures/east.xpm

S ./textures/sprites/sprite_1.xpm
F   128,  128, 128
C   135, 206, 235

111111111111111111111111
101000000000000222222201
101000000000000000000001
100000000022022222220221
100000000000000000000001
102202222220222222202201
100000000000000000000001
102202222220222222202201
100000000000000000000001
102202222220222222202201
100000000000000000000001
102202222220222222202201
100000000000000000000001
102202222220222222202201
100000000000000000000001
102202222220222222202201
100000000000000000000001
102202222220222222202201
100000000000000000000001
102202222220222222202201
100000000000000000000001
102202222220222222202201
100000000000000000000001
102202222220222222202201
100000000000000000000001
102202222220222222202201
1000000000000N0000000001
111111111111111111111111