R 800 800     

NO ./textures/north.xpm     

SO ./textures/south.xpm

WE ./textures/west.xpm

EA ./textures/west.xpm

S ./textures/sprites/sprite_1.xpm

F   34,  34,  128    

C   0, 0, 0    

111111111111111111111
100111S10000000000001
101111011111111111101
101001000000000001101
101011111111111101101
101000000111111101101
101010111100000101101
101010100101110101101
101010101100010101101
101010000001010101101
101010110001010101101
100010100201010101101
101010101111010101101
101111100000010101101
101000111111110101101
101010000000000101101
101011111111111101101
101000000000000001101
101111111111111111101
100000000000000200001
111111111111111111111